{
  "areas": [
    {
      "name": "Main",
      "area_type": 1,
      "area_type_name": "overworld",
      "rows": 13,
      "cols": 223,
      "grid": [
        [
          0, 0, 0, 0, 0, 0, 0, 0, 0, 0, 0, 0, 0, 0, 0, 0, 0, 0, 0, 128, 129,
          130, 0, 0, 0, 0, 0, 0, 0, 0, 0, 0, 0, 0, 0, 0, 128, 129, 129, 130, 0,
          0, 0, 0, 0, 0, 0, 0, 0, 0, 0, 0, 0, 0, 0, 0, 0, 0, 0, 0, 0, 0, 0, 0,
          0, 0, 0, 128, 129, 130, 0, 0, 0, 0, 0, 0, 0, 0, 0, 0, 0, 0, 0, 0, 128,
          129, 129, 130, 0, 0, 0, 0, 0, 0, 0, 0, 0, 0, 0, 0, 0, 0, 0, 0, 0, 0,
          0, 0, 0, 0, 0, 0, 0, 0, 0, 128, 129, 130, 0, 0, 0, 0, 0, 0, 0, 0, 0,
          0, 0, 0, 0, 0, 128, 129, 129, 130, 0, 0, 0, 0, 0, 0, 0, 0, 0, 0, 0, 0,
          0, 0, 0, 0, 0, 0, 0, 0, 0, 0, 0, 0, 0, 0, 0, 128, 129, 130, 0, 0, 0,
          0, 0, 0, 0, 0, 0, 0, 0, 0, 0, 0, 128, 129, 129, 130, 0, 0, 0, 0, 0, 0,
          0, 0, 0, 0, 0, 0, 0, 0, 36, 0, 0, 0, 0, 0, 0, 0, 0, 0, 0, 0, 0, 128,
          129, 130, 0, 0, 0, 0, 0, 0, 0, 0, 0
        ],
        [
          0, 0, 0, 0, 0, 0, 0, 0, 128, 129, 130, 0, 0, 0, 0, 0, 0, 0, 0, 131,
          132, 133, 0, 0, 0, 0, 0, 128, 129, 129, 129, 130, 0, 0, 0, 0, 131,
          132, 132, 133, 0, 0, 0, 0, 0, 0, 0, 0, 0, 0, 0, 0, 0, 0, 0, 0, 128,
          129, 130, 0, 0, 0, 0, 0, 0, 0, 0, 131, 132, 133, 0, 0, 0, 0, 0, 128,
          129, 129, 129, 130, 0, 0, 0, 0, 131, 132, 132, 133, 0, 0, 0, 0, 0, 0,
          0, 0, 0, 0, 0, 0, 0, 0, 0, 0, 128, 129, 130, 0, 0, 0, 0, 0, 0, 0, 0,
          131, 132, 133, 0, 0, 0, 0, 0, 128, 129, 129, 129, 130, 0, 0, 0, 0,
          131, 132, 132, 133, 0, 0, 0, 0, 0, 0, 0, 0, 0, 0, 0, 0, 0, 0, 0, 0,
          128, 129, 130, 0, 0, 0, 0, 0, 0, 0, 0, 131, 132, 133, 0, 0, 0, 0, 0,
          128, 129, 129, 129, 130, 0, 0, 0, 0, 131, 132, 132, 133, 0, 0, 0, 0,
          0, 0, 0, 0, 0, 0, 0, 0, 0, 0, 37, 0, 128, 129, 130, 0, 0, 0, 0, 0, 0,
          0, 0, 131, 132, 133, 0, 0, 0, 0, 0, 128, 129, 129, 129
        ],
        [
          0, 0, 0, 0, 0, 0, 0, 0, 131, 132, 133, 0, 0, 0, 0, 0, 0, 0, 0, 0, 0,
          0, 0, 0, 0, 0, 0, 131, 132, 132, 132, 133, 0, 0, 0, 0, 0, 0, 0, 0, 0,
          0, 0, 0, 0, 0, 0, 0, 0, 0, 0, 0, 0, 0, 0, 0, 131, 132, 133, 0, 0, 0,
          0, 0, 0, 0, 0, 0, 0, 0, 0, 0, 0, 0, 0, 131, 132, 132, 132, 133, 0, 0,
          0, 0, 0, 0, 0, 0, 0, 0, 0, 0, 0, 0, 0, 0, 0, 0, 0, 0, 0, 0, 0, 0, 131,
          132, 133, 0, 0, 0, 0, 0, 0, 0, 0, 0, 0, 0, 0, 0, 0, 0, 0, 131, 132,
          132, 132, 133, 0, 0, 0, 0, 0, 0, 0, 0, 0, 0, 0, 0, 0, 0, 0, 0, 0, 0,
          0, 0, 0, 0, 0, 0, 131, 132, 133, 0, 0, 0, 0, 0, 0, 0, 0, 0, 0, 0, 0,
          0, 0, 0, 0, 131, 132, 132, 132, 133, 0, 0, 0, 0, 0, 0, 0, 0, 0, 0, 0,
          0, 0, 0, 0, 0, 0, 0, 0, 0, 0, 0, 37, 0, 131, 132, 133, 0, 0, 0, 0, 0,
          0, 0, 0, 0, 0, 0, 0, 0, 0, 0, 0, 131, 132, 132, 132
        ],
        [
          0, 0, 0, 0, 0, 0, 0, 0, 0, 0, 0, 0, 0, 0, 0, 0, 0, 0, 0, 0, 0, 0, 192,
          0, 0, 0, 0, 0, 0, 0, 0, 0, 0, 0, 0, 0, 0, 0, 0, 0, 0, 0, 0, 0, 0, 0,
          0, 0, 0, 0, 0, 0, 0, 0, 0, 0, 0, 0, 0, 0, 0, 0, 0, 0, 0, 0, 0, 0, 0,
          0, 0, 0, 0, 0, 0, 0, 0, 0, 0, 0, 81, 81, 81, 81, 81, 81, 81, 81, 0, 0,
          0, 81, 81, 81, 192, 0, 0, 0, 0, 0, 0, 0, 0, 0, 0, 0, 0, 0, 0, 193, 0,
          0, 0, 0, 0, 0, 0, 0, 0, 0, 0, 81, 81, 81, 0, 0, 0, 0, 81, 192, 192,
          81, 0, 0, 0, 0, 0, 0, 0, 0, 0, 0, 0, 0, 0, 0, 0, 0, 0, 0, 0, 0, 0, 0,
          0, 0, 0, 0, 0, 0, 0, 0, 0, 0, 0, 0, 0, 0, 0, 0, 0, 0, 0, 0, 0, 0, 0,
          0, 0, 0, 0, 0, 0, 0, 0, 0, 0, 0, 97, 97, 0, 0, 0, 0, 0, 0, 0, 0, 37,
          0, 0, 0, 0, 0, 0, 0, 0, 0, 0, 0, 0, 0, 0, 0, 0, 0, 0, 0, 0, 0, 0, 0, 0
        ],
        [
          0, 0, 0, 0, 0, 0, 0, 0, 0, 0, 0, 0, 0, 0, 0, 0, 0, 0, 0, 0, 0, 0, 0,
          0, 0, 0, 0, 0, 0, 0, 0, 0, 0, 0, 0, 0, 0, 0, 0, 0, 0, 0, 0, 0, 0, 0,
          0, 0, 0, 0, 0, 0, 0, 0, 0, 0, 0, 0, 0, 0, 0, 0, 0, 0, 0, 0, 0, 0, 0,
          0, 0, 0, 0, 0, 0, 0, 0, 0, 0, 0, 0, 0, 0, 0, 0, 0, 0, 0, 0, 0, 0, 0,
          0, 0, 0, 0, 0, 0, 0, 0, 0, 0, 0, 0, 0, 0, 0, 0, 0, 0, 0, 0, 0, 0, 0,
          0, 0, 0, 0, 0, 0, 0, 0, 0, 0, 0, 0, 0, 0, 0, 0, 0, 0, 0, 0, 0, 0, 0,
          0, 0, 0, 0, 0, 0, 0, 0, 0, 0, 0, 0, 0, 0, 0, 0, 0, 0, 0, 0, 0, 0, 0,
          0, 0, 0, 0, 0, 0, 0, 0, 0, 0, 0, 0, 0, 0, 0, 0, 0, 0, 0, 0, 0, 0, 0,
          0, 0, 0, 97, 97, 97, 0, 0, 0, 0, 0, 0, 0, 0, 37, 0, 0, 0, 0, 0, 0, 0,
          0, 0, 0, 0, 0, 0, 0, 0, 0, 0, 0, 0, 0, 0, 0, 0, 0
        ],
        [
          0, 0, 0, 0, 0, 0, 0, 0, 0, 0, 0, 0, 0, 0, 0, 0, 0, 0, 0, 0, 0, 0, 0,
          0, 0, 0, 0, 0, 0, 0, 0, 0, 0, 0, 0, 0, 0, 0, 0, 0, 0, 0, 0, 0, 0, 0,
          0, 0, 0, 0, 0, 0, 0, 0, 0, 0, 0, 0, 0, 0, 0, 0, 0, 0, 0, 0, 0, 0, 0,
          0, 0, 0, 0, 0, 0, 0, 0, 0, 0, 0, 0, 0, 0, 0, 0, 0, 0, 0, 0, 0, 0, 0,
          0, 0, 0, 0, 0, 0, 0, 0, 0, 0, 0, 0, 0, 0, 0, 0, 0, 0, 0, 0, 0, 0, 0,
          0, 0, 0, 0, 0, 0, 0, 0, 0, 0, 0, 0, 0, 0, 0, 0, 0, 0, 0, 0, 0, 0, 0,
          0, 0, 0, 0, 0, 0, 0, 0, 0, 0, 0, 0, 0, 0, 0, 0, 0, 0, 0, 0, 0, 0, 0,
          0, 0, 0, 0, 0, 0, 0, 0, 0, 0, 0, 0, 0, 0, 0, 0, 0, 0, 0, 0, 0, 0, 0,
          0, 0, 97, 97, 97, 97, 0, 0, 0, 0, 0, 0, 0, 0, 37, 0, 0, 0, 0, 0, 0, 0,
          0, 0, 0, 0, 0, 0, 0, 0, 0, 0, 0, 0, 0, 0, 0, 0, 0
        ],
        [
          0, 0, 0, 0, 0, 0, 0, 0, 0, 0, 0, 0, 0, 0, 0, 0, 0, 0, 0, 0, 0, 0, 0,
          0, 0, 0, 0, 0, 0, 0, 0, 0, 0, 0, 0, 0, 0, 0, 0, 0, 0, 0, 0, 0, 0, 0,
          0, 0, 0, 0, 0, 0, 0, 0, 0, 0, 0, 0, 0, 0, 0, 0, 0, 0, 0, 0, 0, 0, 0,
          0, 0, 0, 0, 0, 0, 0, 0, 0, 0, 0, 0, 0, 0, 0, 0, 0, 0, 0, 0, 0, 0, 0,
          0, 0, 0, 0, 0, 0, 0, 0, 0, 0, 0, 0, 0, 0, 0, 0, 0, 0, 0, 0, 0, 0, 0,
          0, 0, 0, 0, 0, 0, 0, 0, 0, 0, 0, 0, 0, 0, 0, 0, 0, 0, 0, 0, 0, 0, 0,
          0, 0, 0, 0, 0, 0, 0, 0, 0, 0, 0, 0, 0, 0, 0, 0, 0, 0, 0, 0, 0, 0, 0,
          0, 0, 0, 0, 0, 0, 0, 0, 0, 0, 0, 0, 0, 0, 0, 0, 0, 0, 0, 0, 0, 0, 0,
          0, 97, 97, 97, 97, 97, 0, 0, 0, 0, 0, 0, 0, 0, 37, 0, 0, 0, 0, 69, 69,
          69, 0, 0, 0, 0, 0, 0, 0, 0, 0, 0, 0, 0, 0, 0, 0, 0, 0
        ],
        [
          0, 0, 0, 0, 0, 0, 0, 0, 0, 0, 0, 0, 0, 0, 0, 0, 192, 0, 0, 0, 81, 193,
          81, 192, 81, 0, 0, 0, 0, 0, 0, 0, 0, 0, 0, 0, 0, 0, 0, 0, 0, 0, 0, 0,
          0, 0, 18, 19, 0, 0, 0, 0, 0, 0, 0, 0, 0, 16, 17, 0, 0, 0, 0, 0, 0, 0,
          0, 0, 0, 0, 0, 0, 0, 0, 0, 0, 0, 81, 193, 81, 0, 0, 0, 0, 0, 0, 0, 0,
          0, 0, 0, 0, 0, 0, 88, 0, 0, 0, 0, 0, 81, 87, 0, 0, 0, 0, 192, 0, 0,
          192, 0, 0, 192, 0, 0, 0, 0, 0, 81, 0, 0, 0, 0, 0, 0, 0, 0, 0, 0, 81,
          81, 0, 0, 0, 0, 0, 0, 97, 0, 0, 97, 0, 0, 0, 0, 0, 0, 0, 0, 0, 0, 97,
          97, 0, 0, 97, 0, 0, 0, 0, 0, 0, 0, 0, 0, 0, 0, 0, 81, 81, 192, 81, 0,
          0, 0, 0, 0, 0, 0, 0, 0, 0, 0, 0, 97, 97, 97, 97, 97, 97, 0, 0, 0, 0,
          0, 0, 0, 0, 37, 0, 0, 0, 0, 70, 71, 72, 0, 0, 0, 0, 0, 0, 0, 0, 0, 0,
          0, 0, 0, 0, 0, 0, 0
        ],
        [
          0, 0, 7, 0, 0, 0, 0, 0, 0, 0, 0, 0, 0, 0, 0, 0, 0, 0, 0, 0, 0, 0, 0,
          0, 0, 0, 0, 0, 0, 0, 0, 0, 0, 0, 0, 0, 0, 0, 18, 19, 0, 0, 0, 0, 0, 0,
          20, 21, 0, 0, 7, 0, 0, 0, 0, 0, 0, 20, 21, 0, 0, 0, 0, 0, 0, 0, 0, 0,
          0, 0, 0, 0, 0, 0, 0, 0, 0, 0, 0, 0, 0, 0, 0, 0, 0, 0, 0, 0, 0, 0, 0,
          0, 0, 0, 0, 0, 0, 0, 7, 0, 0, 0, 0, 0, 0, 0, 0, 0, 0, 0, 0, 0, 0, 0,
          0, 0, 0, 0, 0, 0, 0, 0, 0, 0, 0, 0, 0, 0, 0, 0, 0, 0, 0, 0, 0, 0, 97,
          97, 0, 0, 97, 97, 0, 0, 0, 0, 7, 0, 0, 0, 97, 97, 97, 0, 0, 97, 97, 0,
          0, 0, 0, 0, 0, 0, 0, 0, 0, 0, 0, 0, 0, 0, 0, 0, 0, 0, 0, 0, 0, 0, 0,
          0, 0, 97, 97, 97, 97, 97, 97, 97, 0, 0, 0, 0, 7, 0, 0, 0, 37, 0, 0, 0,
          69, 73, 73, 73, 69, 0, 0, 0, 0, 0, 0, 0, 0, 0, 0, 0, 0, 0, 0, 0, 0
        ],
        [
          0, 5, 6, 8, 0, 0, 0, 0, 0, 0, 0, 0, 0, 0, 0, 0, 0, 7, 0, 0, 0, 0, 0,
          0, 0, 0, 0, 0, 18, 19, 0, 0, 0, 0, 0, 0, 0, 0, 20, 21, 0, 0, 0, 0, 0,
          0, 20, 21, 0, 5, 6, 8, 0, 0, 0, 0, 0, 20, 21, 0, 0, 0, 0, 0, 0, 7, 0,
          0, 0, 0, 0, 0, 0, 0, 0, 0, 0, 0, 0, 0, 0, 0, 0, 0, 0, 0, 0, 0, 0, 0,
          0, 0, 0, 0, 0, 0, 0, 5, 6, 8, 0, 0, 0, 0, 0, 0, 0, 0, 0, 0, 0, 0, 0,
          7, 0, 0, 0, 0, 0, 0, 0, 0, 0, 0, 0, 0, 0, 0, 0, 0, 0, 0, 0, 0, 0, 97,
          97, 97, 0, 0, 97, 97, 97, 0, 0, 5, 6, 8, 0, 97, 97, 97, 97, 0, 0, 97,
          97, 97, 0, 0, 0, 7, 0, 18, 19, 0, 0, 0, 0, 0, 0, 0, 0, 0, 0, 0, 0, 0,
          0, 18, 19, 0, 97, 97, 97, 97, 97, 97, 97, 97, 0, 0, 0, 5, 6, 8, 0, 0,
          37, 0, 0, 0, 71, 71, 74, 71, 71, 0, 0, 7, 0, 0, 0, 0, 0, 0, 0, 0, 0,
          0, 0, 0, 0
        ],
        [
          5, 6, 10, 9, 8, 0, 0, 0, 0, 0, 0, 2, 3, 3, 3, 4, 5, 6, 8, 0, 0, 0, 0,
          2, 3, 4, 0, 0, 20, 21, 0, 0, 0, 0, 0, 0, 0, 0, 20, 21, 0, 2, 3, 3, 4,
          0, 20, 21, 5, 6, 10, 9, 8, 0, 0, 0, 0, 20, 21, 2, 3, 3, 3, 4, 5, 6, 8,
          0, 0, 0, 0, 2, 3, 4, 0, 0, 0, 0, 0, 0, 0, 0, 0, 0, 0, 0, 0, 0, 0, 2,
          3, 3, 4, 0, 0, 0, 5, 6, 10, 9, 8, 0, 0, 0, 0, 0, 0, 2, 3, 3, 3, 4, 5,
          6, 8, 0, 0, 0, 0, 2, 3, 4, 0, 0, 0, 0, 0, 0, 0, 0, 0, 0, 0, 0, 97, 97,
          97, 97, 3, 3, 97, 97, 97, 97, 5, 6, 10, 9, 97, 97, 97, 97, 97, 0, 0,
          97, 97, 97, 97, 4, 5, 6, 8, 20, 21, 0, 0, 2, 3, 4, 0, 0, 0, 0, 0, 0,
          0, 0, 0, 20, 21, 97, 97, 97, 97, 97, 97, 97, 97, 97, 0, 0, 5, 6, 10,
          9, 8, 0, 97, 0, 0, 0, 71, 71, 75, 82, 71, 4, 5, 6, 8, 0, 0, 0, 0, 2,
          3, 4, 0, 0, 0, 0, 0
        ],
        [
          84, 84, 84, 84, 84, 84, 84, 84, 84, 84, 84, 84, 84, 84, 84, 84, 84,
          84, 84, 84, 84, 84, 84, 84, 84, 84, 84, 84, 84, 84, 84, 84, 84, 84,
          84, 84, 84, 84, 84, 84, 84, 84, 84, 84, 84, 84, 84, 84, 84, 84, 84,
          84, 84, 84, 84, 84, 84, 84, 84, 84, 84, 84, 84, 84, 84, 84, 84, 84,
          84, 0, 0, 84, 84, 84, 84, 84, 84, 84, 84, 84, 84, 84, 84, 84, 84, 84,
          0, 0, 0, 84, 84, 84, 84, 84, 84, 84, 84, 84, 84, 84, 84, 84, 84, 84,
          84, 84, 84, 84, 84, 84, 84, 84, 84, 84, 84, 84, 84, 84, 84, 84, 84,
          84, 84, 84, 84, 84, 84, 84, 84, 84, 84, 84, 84, 84, 84, 84, 84, 84,
          84, 84, 84, 84, 84, 84, 84, 84, 84, 84, 84, 84, 84, 84, 84, 0, 0, 84,
          84, 84, 84, 84, 84, 84, 84, 84, 84, 84, 84, 84, 84, 84, 84, 84, 84,
          84, 84, 84, 84, 84, 84, 84, 84, 84, 84, 84, 84, 84, 84, 84, 84, 84,
          84, 84, 84, 84, 84, 84, 84, 84, 84, 84, 84, 84, 84, 84, 84, 84, 84,
          84, 84, 84, 84, 84, 84, 84, 84, 84, 84, 84, 84, 84, 84, 84, 84
        ],
        [
          84, 84, 84, 84, 84, 84, 84, 84, 84, 84, 84, 84, 84, 84, 84, 84, 84,
          84, 84, 84, 84, 84, 84, 84, 84, 84, 84, 84, 84, 84, 84, 84, 84, 84,
          84, 84, 84, 84, 84, 84, 84, 84, 84, 84, 84, 84, 84, 84, 84, 84, 84,
          84, 84, 84, 84, 84, 84, 84, 84, 84, 84, 84, 84, 84, 84, 84, 84, 84,
          84, 0, 0, 84, 84, 84, 84, 84, 84, 84, 84, 84, 84, 84, 84, 84, 84, 84,
          0, 0, 0, 84, 84, 84, 84, 84, 84, 84, 84, 84, 84, 84, 84, 84, 84, 84,
          84, 84, 84, 84, 84, 84, 84, 84, 84, 84, 84, 84, 84, 84, 84, 84, 84,
          84, 84, 84, 84, 84, 84, 84, 84, 84, 84, 84, 84, 84, 84, 84, 84, 84,
          84, 84, 84, 84, 84, 84, 84, 84, 84, 84, 84, 84, 84, 84, 84, 0, 0, 84,
          84, 84, 84, 84, 84, 84, 84, 84, 84, 84, 84, 84, 84, 84, 84, 84, 84,
          84, 84, 84, 84, 84, 84, 84, 84, 84, 84, 84, 84, 84, 84, 84, 84, 84,
          84, 84, 84, 84, 84, 84, 84, 84, 84, 84, 84, 84, 84, 84, 84, 84, 84,
          84, 84, 84, 84, 84, 84, 84, 84, 84, 84, 84, 84, 84, 84, 84, 84
        ]
      ],
      "entities": [
        {
          "type": "goomba",
          "id": 6,
          "page": 0,
          "col": 6,
          "row": 11,
          "x_in_page": 6,
          "hard_only": false
        },
        {
          "type": "goomba",
          "id": 6,
          "page": 1,
          "col": 24,
          "row": 11,
          "x_in_page": 8,
          "hard_only": false
        },
        {
          "type": "goomba_duo_lo",
          "id": 55,
          "page": 2,
          "col": 38,
          "row": 3,
          "x_in_page": 6,
          "hard_only": false
        },
        {
          "type": "goomba",
          "id": 6,
          "page": 5,
          "col": 80,
          "row": 3,
          "x_in_page": 0,
          "hard_only": false
        },
        {
          "type": "goomba",
          "id": 6,
          "page": 5,
          "col": 82,
          "row": 3,
          "x_in_page": 2,
          "hard_only": false
        },
        {
          "type": "goomba_duo_lo",
          "id": 55,
          "page": 6,
          "col": 100,
          "row": 11,
          "x_in_page": 4,
          "hard_only": false
        },
        {
          "type": "koopa_green",
          "id": 0,
          "page": 6,
          "col": 107,
          "row": 11,
          "x_in_page": 11,
          "hard_only": false
        },
        {
          "type": "goomba_duo_lo",
          "id": 55,
          "page": 7,
          "col": 117,
          "row": 11,
          "x_in_page": 5,
          "hard_only": false
        },
        {
          "type": "goomba_duo_lo",
          "id": 55,
          "page": 7,
          "col": 127,
          "row": 11,
          "x_in_page": 15,
          "hard_only": false
        },
        {
          "type": "goomba_duo_lo",
          "id": 55,
          "page": 8,
          "col": 131,
          "row": 11,
          "x_in_page": 3,
          "hard_only": false
        },
        {
          "type": "goomba_duo_lo",
          "id": 55,
          "page": 11,
          "col": 177,
          "row": 11,
          "x_in_page": 1,
          "hard_only": false
        }
      ]
    },
    {
      "name": "Bonus Room",
      "area_type": 2,
      "area_type_name": "underground",
      "rows": 13,
      "cols": 32,
      "grid": [
        [
          82, 0, 0, 0, 82, 82, 82, 82, 82, 82, 82, 0, 0, 0, 0, 20, 21, 0, 0, 0,
          0, 0, 0, 0, 0, 0, 0, 0, 0, 0, 0, 0
        ],
        [
          82, 0, 0, 0, 0, 0, 0, 0, 0, 0, 0, 0, 0, 0, 0, 20, 21, 0, 0, 0, 0, 0,
          0, 0, 0, 0, 0, 0, 0, 0, 0, 0
        ],
        [
          82, 0, 0, 0, 0, 0, 0, 0, 0, 0, 0, 0, 0, 0, 0, 20, 21, 0, 0, 0, 0, 0,
          0, 0, 0, 0, 0, 0, 0, 0, 0, 0
        ],
        [
          82, 0, 0, 0, 0, 194, 194, 194, 194, 194, 0, 0, 0, 0, 0, 20, 21, 0, 0,
          0, 0, 0, 0, 0, 0, 0, 0, 0, 0, 0, 0, 0
        ],
        [
          82, 0, 0, 0, 0, 0, 0, 0, 0, 0, 0, 0, 0, 0, 0, 20, 21, 0, 0, 0, 0, 0,
          0, 0, 0, 0, 0, 0, 0, 0, 0, 0
        ],
        [
          82, 0, 0, 0, 194, 194, 194, 194, 194, 194, 194, 0, 0, 0, 0, 20, 21, 0,
          0, 0, 0, 0, 0, 0, 0, 0, 0, 0, 0, 0, 0, 0
        ],
        [
          82, 0, 0, 0, 0, 0, 0, 0, 0, 0, 0, 0, 0, 0, 0, 20, 21, 0, 0, 0, 0, 0,
          0, 0, 0, 0, 0, 0, 0, 0, 0, 0
        ],
        [
          82, 0, 0, 0, 194, 194, 194, 194, 194, 194, 194, 0, 0, 0, 0, 20, 21, 0,
          0, 0, 0, 0, 0, 0, 0, 0, 0, 0, 0, 0, 0, 0
        ],
        [
          82, 0, 0, 0, 82, 82, 82, 82, 82, 82, 82, 0, 0, 0, 0, 20, 21, 0, 0, 0,
          0, 0, 0, 0, 0, 0, 0, 0, 0, 0, 0, 0
        ],
        [
          82, 0, 0, 0, 82, 82, 82, 82, 82, 82, 82, 0, 0, 28, 29, 30, 21, 0, 0,
          0, 0, 0, 0, 0, 0, 0, 0, 0, 0, 0, 0, 0
        ],
        [
          82, 0, 0, 0, 82, 82, 82, 82, 82, 82, 82, 0, 0, 31, 32, 33, 21, 0, 0,
          0, 0, 0, 0, 0, 0, 0, 0, 0, 0, 0, 0, 0
        ],
        [
          84, 84, 84, 84, 84, 84, 84, 84, 84, 84, 84, 84, 84, 84, 84, 84, 84,
          84, 84, 84, 84, 84, 84, 84, 84, 84, 84, 84, 84, 84, 84, 84
        ],
        [
          84, 84, 84, 84, 84, 84, 84, 84, 84, 84, 84, 84, 84, 84, 84, 84, 84,
          84, 84, 84, 84, 84, 84, 84, 84, 84, 84, 84, 84, 84, 84, 84
        ]
      ],
      "entities": []
    }
  ]
}
